21 21
0 8 2 2 2 2 2 2 2 2 4 2 2 2 2 2 2 2 2 9 0
0 1 8 0 0 0 0 0 0 0 1 0 0 0 0 0 0 0 0 1 0
0 1 0 c e 0 c 2 e 0 f 0 c 2 e 0 c e 0 1 0
0 1 0 0 0 0 0 0 0 0 0 0 0 0 0 0 0 0 0 1 0
0 1 0 c e 0 d 0 c 2 4 2 e 0 d 0 c e 0 1 0
0 1 0 0 0 0 1 0 0 0 1 0 0 0 1 0 0 0 0 1 0
0 b 2 2 9 0 7 2 e 0 f  0 c 2 5 0 8 2 2 a 0
0 0 0 0 1 0 1 0 0 0 0 0 0 0 1 0 1 0 0 0 0 
2 2 2 2 a 0 f 0 8 2 2 2 9 0 f 0 b 2 2 2 2 
0 0 0 0 0 0 0 0 1 0 0 0 1 0 0 0 0 0 0 0 0
2 2 2 2 9 0 d 0 b 2 2 2 a 0 d 0 8 2 2 2 2
0 0 0 0 1 0 1 0 0 0 0 0 0 0 1 0 1 0 0 0 0
0 8 2 2 a 0 f 0 c 2 4 2 e 0 f 0 b 2 2 9 0 
0 1 0 0 0 0 0 0 0 0 1 0 0 0 0 0 0 0 0 1 0 
0 1  0 c 9 0 c 2 e 0 f 0 c 2 e 0 8 e 0 1 0
0 1 0 0 1 0 0 0 0 0 0 0 0 0 0 0 1 0 0 1 0
0 7 e 0 f 0 d 0 c 2 4 2 e 0 d 0 f 0 c 5 0
0 1 0 0 0 2 1 0 0 0 1 0 0 0 1 0 0 0 0 1 0 
0 1 0 c 2 2 6 2 e 0 f 0 c 2 6 2 2 e 0 1 0
0 1 0 0 0 0 0 0 0 0 0 0 0 0 0 0 0 0 0 1 0
0 b 2 2 2 2 2 2 2 2 2 2 2 2 2 2 2 2 2 a 0  

0 0 0 0 0 0 0 0 0 0 0 0 0 0 0 0 0 0 0 0 0
0 0 g g g g g g g g 0 g g g g g g g g 0 0
0 0 g 0 0 g 0 0 0 g 0 g 0 0 0 g 0 0 g 0 0
0 0 g g g g g g g g g g g g g g g g g 0 0
0 0 g 0 0 g 0 g 0 0 0 0 0 g 0 g 0 0 g 0 0
0 0 g g g g 0 g g g 0 g g g 0 g g g g 0 0
0 0 0 0 0 g 0 0 0 g 0 g 0 0 0 g 0 0 0 0 0
0 0 0 0 0 g 0 g g g g g g g 0 g 0 0 0 0 0
0 0 0 0 0 g 0 g 0 0 0 0 0 g 0 g 0 0 0 0 0
g g g g g g g g 0 0 0 0 0 g g g g g g g g
0 0 0 0 0 g 0 g 0 0 0 0 0 g 0 g 0 0 0 0 0
0 0 0 0 0 g 0 g g g g g g g 0 g 0 0 0 0 0
0 0 0 0 0 g 0 g 0 0 0 0 0 g 0 g 0 0 0 0 0
0 0 g g g g g g g g 0 g g g g g g g g 0 0
0 0 g 0 0 g 0 0 0 g 0 g 0 0 0 g 0 0 g 0 0
0 0 g g 0 g g g g g g g g g g g 0 g g 0 0
0 0 0 g 0 g 0 g 0 0 0 0 0 g 0 g 0 g 0 0 0
0 0 g g g g 0 g g g 0 g g g 0 g g g g 0 0
0 0 g 0 0 0 0 0 0 g 0 g 0 0 0 0 0 0 g 0 0
0 0 g g g g g g g g g g g g g g g g g 0 0
0 0 0 0 0 0 0 0 0 0 0 0 0 0 0 0 0 0 0 0 0